NO path_for_mapstexture/n_flame.xpm
SO path_for_mapstexture/s_flame.xpm
WE path_for_mapstexture/w_flame.xpm
EA path_for_mapstexture/e_flame.xpm

F 34,139,34
C 70,130,180

1111111111111111111111111
1000000000000000000000001
1000011111001111001110001
1000010001000000001010001
1111010111110111101010111
1000000100S00100000000001
1000000101010101111110001
1011100101010001000010001
1000100000011111000010001
1000100010000010000010001
1011100010000010111110111
1000000010000000000000001
1011111010111111111111111
1111111111111111111111111
