NO path_for_mapstexture/n_flame.xpm
SO path_for_mapstexture/s_flame.xpm
WE path_for_mapstexture/w_flame.xpm
EA path_for_mapstexture/e_flame.xpm

F 128,0,128
C 255,228,181

1111111111111111111111111
1000000000000000000000001
1011111111111111100011101
1000000000000000100000001
1111111111101111110111111
1000000000001000000000001
1011101111101111111101111
10100010000000E0000000001
1010001111110111111101111
1000001000010000000100001
1111111010111111110101111
1000000000000000000100001
1000111111111111111111101
1111111111111111111111111
