NO path_for_mapstexture/n_flame.xpm
SO path_for_mapstexture/s_flame.xpm
WE path_for_mapstexture/w_flame.xpm
EA path_for_mapstexture/e_flame.xpm

F 200,200,50
C 25,25,112

1111111111111111111111111
1000000000000000000000001
1000000000000000111100001
1000111111100010100000001
1000000000100010101111101
1111111110111110110000001
1000000000000000001111101
1011111111111111110000001
1000000000000000011111101
1000000000000000000000001
1111111111011111111011111
1000000000000000000010001
1000000000000000000000001
1111111111111111111111111
